AAPEP|AA|bgtBA|_bgtA	AAPEP|AA|bgtAB|bgtA	AAPEP|AA|bgtAB|bgtA
AAPEP|AA|bgtBA|_bgtB	AAPEP|AA|bgtAB|bgtB	AAPEP|AA|bgtAB|bgtB
AAPEP|AA|livFGHKM|_livF	AAPEP|AA|livFGHKM|livF	AAPEP|AA|livFGHKM|livF
AAPEP|AA|livFGHKM|_livG	AAPEP|AA|livFGHKM|livG	AAPEP|AA|livFGHKM|livG
AAPEP|AA|livFGHKM|_livH	AAPEP|AA|livFGHKM|livK	AAPEP|AA|livFGHKM|livK
AAPEP|AA|livFGHKM|_livK	AAPEP|AA|livFGHKM|livH	AAPEP|AA|livFGHKM|livH
AAPEP|AA|livFGHKM|_livM	AAPEP|AA|livFGHKM|livM	AAPEP|AA|livFGHKM|livM
AAPEP|AA|natABCDE|_natA	AAPEP|AA|natABCDE|natA	AAPEP|AA|natABCDE|natA
AAPEP|AA|natABCDE|_natB	AAPEP|AA|natABCDE|natB	AAPEP|AA|natABCDE|natB
AAPEP|AA|natABCDE|_natC	AAPEP|AA|natABCDE|natC	AAPEP|AA|natABCDE|natC
AAPEP|AA|natABCDE|_natD	AAPEP|AA|natABCDE|natD	AAPEP|AA|natABCDE|natD
AAPEP|AA|natABCDE|_natE	AAPEP|AA|natABCDE|natE	AAPEP|AA|natABCDE|natE
AAPEP|aa|aapJMPQ|_aapJ	AAPEP|AA|aapJMPQ|aapJ	AAPEP|AA|aapJMPQ|aapJ
AAPEP|aa|aapJMPQ|_aapM	AAPEP|AA|aapJMPQ|aapM	AAPEP|AA|aapJMPQ|aapM
AAPEP|aa|aapJMPQ|_aapP	AAPEP|AA|aapJMPQ|aapP	AAPEP|AA|aapJMPQ|aapP
AAPEP|aa|aapJMPQ|_aapQ	AAPEP|AA|aapJMPQ|aapQ	AAPEP|AA|aapJMPQ|aapQ
AAPEP|aa|aotJMPQ|_aotJ	AAPEP|AA|aotJMPQ|aotJ	AAPEP|AA|aotJMPQ|aotJ
AAPEP|aa|aotJMPQ|_aotM	AAPEP|AA|aotJMPQ|aotM	AAPEP|AA|aotJMPQ|aotM
AAPEP|aa|aotJMPQ|_aotP	AAPEP|AA|aotJMPQ|aotP	AAPEP|AA|aotJMPQ|aotP
AAPEP|aa|aotJMPQ|_aotQ	AAPEP|AA|aotJMPQ|aotQ	AAPEP|AA|aotJMPQ|aotQ
AAPEP|aa|artIJMPQ|_artI	AAPEP|AA|artIJMPQ|artI	AAPEP|AA|artIJMPQ|artI
AAPEP|aa|artIJMPQ|_artJ	AAPEP|AA|artIJMPQ|artJ	AAPEP|AA|artIJMPQ|artJ
AAPEP|aa|artIJMPQ|_artM	AAPEP|AA|artIJMPQ|artM	AAPEP|AA|artIJMPQ|artM
AAPEP|aa|artIJMPQ|_artP	AAPEP|AA|artIJMPQ|artP	AAPEP|AA|artIJMPQ|artP
AAPEP|aa|artIJMPQ|_artQ	AAPEP|AA|artIJMPQ|artQ	AAPEP|AA|artIJMPQ|artQ
AAPEP|aa|braCDEFG|_braC	AAPEP|AA|braCDEFG|braC	AAPEP|AA|braCDEFG|braC
AAPEP|aa|braCDEFG|_braD	AAPEP|AA|braCDEFG|braD	AAPEP|AA|braCDEFG|braD
AAPEP|aa|braCDEFG|_braE	AAPEP|AA|braCDEFG|braE	AAPEP|AA|braCDEFG|braE
AAPEP|aa|braCDEFG|_braF	AAPEP|AA|braCDEFG|braF	AAPEP|AA|braCDEFG|braF
AAPEP|aa|braCDEFG|_braG	AAPEP|AA|braCDEFG|braG	AAPEP|AA|braCDEFG|braG
AAPEP|aa|busAB|_busA	AAPEP|PEP|busAB|busA	AAPEP|PEP|busAB|busA
AAPEP|aa|busAB|_busB	AAPEP|PEP|busAB|busB	AAPEP|PEP|busAB|busB
AAPEP|aa|bztABCD|_bztA	AAPEP|AA|bztABCD|bztA	AAPEP|AA|bztABCD|bztA
AAPEP|aa|bztABCD|_bztB	AAPEP|AA|bztABCD|bztB	AAPEP|AA|bztABCD|bztB
AAPEP|aa|bztABCD|_bztC	AAPEP|AA|bztABCD|bztC	AAPEP|AA|bztABCD|bztC
AAPEP|aa|bztABCD|_bztD	AAPEP|AA|bztABCD|bztD	AAPEP|AA|bztABCD|bztD
AAPEP|aa|dppABCDF|_dppA	AAPEP|AA|dppABCDF|dppA	AAPEP|AA|dppABCDF|dppA
AAPEP|aa|dppABCDF|_dppB	AAPEP|AA|dppABCDF|dppB	AAPEP|AA|dppABCDF|dppB
AAPEP|aa|dppABCDF|_dppC	AAPEP|AA|dppABCDF|dppC	AAPEP|AA|dppABCDF|dppC
AAPEP|aa|dppABCDF|_dppD	AAPEP|AA|dppABCDF|dppD	AAPEP|AA|dppABCDF|dppD
AAPEP|aa|dppABCDF|_dppF	AAPEP|AA|dppABCDF|dppF	AAPEP|AA|dppABCDF|dppF
AAPEP|aa|gadC|_gadC	AAPEP|AA|gadC|gadC	AAPEP|AA|gadC|gadC
AAPEP|aa|glnHPQ|_glnH	AAPEP|AA|glnHPQ|glnH	AAPEP|AA|glnHPQ|glnH
AAPEP|aa|glnHPQ|_glnP	AAPEP|AA|glnHPQ|glnP	AAPEP|AA|glnHPQ|glnP
AAPEP|aa|glnHPQ|_glnQ	AAPEP|AA|glnHPQ|glnQ	AAPEP|AA|glnHPQ|glnQ
AAPEP|aa|gltIJKL|_gltI	AAPEP|AA|gltIJKL|gltI	AAPEP|AA|gltIJKL|gltI
AAPEP|aa|gltIJKL|_gltJ	AAPEP|AA|gltIJKL|gltJ	AAPEP|AA|gltIJKL|gltJ
AAPEP|aa|gltIJKL|_gltK	AAPEP|AA|gltIJKL|gltK	AAPEP|AA|gltIJKL|gltK
AAPEP|aa|gltIJKL|_gltL	AAPEP|AA|gltIJKL|gltL	AAPEP|AA|gltIJKL|gltL
AAPEP|aa|gltP|_gltP	AAPEP|AA|gltP|gltP	AAPEP|AA|gltP|gltP
AAPEP|aa|gltS|_gltS	AAPEP|AA|gltS|gltS	AAPEP|AA|gltS|gltS
AAPEP|aa|gluABCD|_gluA	AAPEP|PEP|gluABCD|gluA	AAPEP|PEP|gluABCD|gluA
AAPEP|aa|gluABCD|_gluB	AAPEP|PEP|gluABCD|gluB	AAPEP|PEP|gluABCD|gluB
AAPEP|aa|gluABCD|_gluC	AAPEP|PEP|gluABCD|gluC	AAPEP|PEP|gluABCD|gluC
AAPEP|aa|gluABCD|_gluD	AAPEP|PEP|gluABCD|gluD	AAPEP|PEP|gluABCD|gluD
AAPEP|aa|hisJMPQ|_hisJ	AAPEP|AA|hisJ|hisJ	AAPEP|AA|hisJ|hisJ
AAPEP|aa|hisPMQ-argT|_argT	AAPEP|AA|arhPMQT|arhT	AAPEP|AA|hisPMQ-argT|argT
AAPEP|aa|hisPMQ-argT|_hisM	AAPEP|AA|arhPMQT|arhM	AAPEP|AA|hisPMQ-argT|hisM
AAPEP|aa|hisPMQ-argT|_hisP	AAPEP|AA|arhPMQT|arhP	AAPEP|AA|hisPMQ-argT|hisP
AAPEP|aa|hisPMQ-argT|_hisQ	AAPEP|AA|arhPMQT|arhQ	AAPEP|AA|hisPMQ-argT|hisQ
AAPEP|aa|hutVWX|_hutV	AAPEP|AA|hutVWX|hutV	AAPEP|AA|hutVWX|hutV
AAPEP|aa|hutVWX|_hutW	AAPEP|AA|hutVWX|hutW	AAPEP|AA|hutVWX|hutW
AAPEP|aa|hutVWX|_hutX	AAPEP|AA|hutVWX|hutX	AAPEP|AA|hutVWX|hutX
AAPEP|aa|livFGHJMK|_livF	AAPEP|AA|livFGHMK|livF	AAPEP|AA|livFGHMK|livF
AAPEP|aa|livFGHJMK|_livG	AAPEP|AA|livFGHMK|livG	AAPEP|AA|livFGHMK|livG
AAPEP|aa|livFGHJMK|_livH	AAPEP|AA|livFGHMK|livH	AAPEP|AA|livFGHMK|livH
AAPEP|aa|livFGHJMK|_livJ	DELETE	DELETE
AAPEP|aa|livFGHJMK|_livK	AAPEP|AA|livFGHMK|livK	AAPEP|AA|livFGHMK|livK
AAPEP|aa|livFGHJMK|_livM	AAPEP|AA|livFGHMK|livM	AAPEP|AA|livFGHMK|livM
AAPEP|aa|nocMPQT|_nocM	AAPEP|AA|nocMPQT|nocM	AAPEP|AA|nocMPQT|nocM
AAPEP|aa|nocMPQT|_nocP	AAPEP|AA|nocMPQT|nocP	AAPEP|AA|nocMPQT|nocP
AAPEP|aa|nocMPQT|_nocQ	AAPEP|AA|nocMPQT|nocQ	AAPEP|AA|nocMPQT|nocQ
AAPEP|aa|nocMPQT|_nocT	AAPEP|AA|nocMPQT|nocT	AAPEP|AA|nocMPQT|nocT
AAPEP|aa|occMPQT|_occM	AAPEP|AA|occMPQT|occM	AAPEP|AA|occMPQT|occM
AAPEP|aa|occMPQT|_occP	AAPEP|AA|occMPQT|occP	AAPEP|AA|occMPQT|occP
AAPEP|aa|occMPQT|_occQ	AAPEP|AA|occMPQT|occQ	AAPEP|AA|occMPQT|occQ
AAPEP|aa|occMPQT|_occT	AAPEP|AA|occMPQT|occT	AAPEP|AA|occMPQT|occT
AAPEP|aa|oppBCDF-mppA|_mppA	AAPEP|AA|oppABCDF|oppA	AAPEP|AA|oppABCDF|oppA
AAPEP|aa|oppBCDF-mppA|_oppB	AAPEP|AA|oppABCDF|oppB	AAPEP|AA|oppABCDF|oppB
AAPEP|aa|oppBCDF-mppA|_oppC	AAPEP|AA|oppABCDF|oppC	AAPEP|AA|oppABCDF|oppC
AAPEP|aa|oppBCDF-mppA|_oppD	AAPEP|AA|oppABCDF|oppD	AAPEP|AA|oppABCDF|oppD
AAPEP|aa|oppBCDF-mppA|_oppF	AAPEP|AA|oppABCDF|oppF	AAPEP|AA|oppABCDF|oppF
AAPEP|aa|proVWX|_proV	AAPEP|AA|proVWX|proV	AAPEP|AA|proVWX|proV
AAPEP|aa|proVWX|_proW	AAPEP|AA|proVWX|proW	AAPEP|AA|proVWX|proW
AAPEP|aa|proVWX|_proX	AAPEP|AA|proVWX|proX	AAPEP|AA|proVWX|proX
AAPEP|aa|sapABCDF|_sapA	DELETE	DELETE
AAPEP|aa|sapABCDF|_sapB	DELETE	DELETE
AAPEP|aa|sapABCDF|_sapC	DELETE	DELETE
AAPEP|aa|sapABCDF|_sapD	DELETE	DELETE
AAPEP|aa|sapABCDF|_sapF	DELETE	DELETE
AAPEP|aa|tppB|_tppB	AAPEP|PEP|tppB|tppB	AAPEP|PEP|tppB|tppB
AAPEP|aa|yecCS-fliY|_fliY	AAPEP|AA|yefCSY|yefY	AAPEP|AA|yecCS-fliY|fliY
AAPEP|aa|yecCS-fliY|_yecC	AAPEP|AA|yefCSY|yefC	AAPEP|AA|yecCS-fliY|yecC
AAPEP|aa|yecCS-fliY|_yecS	AAPEP|AA|yefCSY|yefS	AAPEP|AA|yecCS-fliY|yecS
AAPEP|aa|yejABEF|_yejA	AAPEP|AA|yejABEF|yejA	AAPEP|AA|yejABEF|yejA
AAPEP|aa|yejABEF|_yejB	AAPEP|AA|yejABEF|yejB	AAPEP|AA|yejABEF|yejB
AAPEP|aa|yejABEF|_yejE	AAPEP|AA|yejABEF|yejE	AAPEP|AA|yejABEF|yejE
AAPEP|aa|yejABEF|_yejF	AAPEP|AA|yejABEF|yejF	AAPEP|AA|yejABEF|yejF
Akinete|Ana|aet-hap-aapN-avaK|_aapN	Akinete|Akr|ahkABNK|ahkN	Akinete|Akr|aet-hap-aapN-avaK|aapN
Akinete|Ana|aet-hap-aapN-avaK|_aet	Akinete|Akr|ahkABNK|ahkA	Akinete|Akr|aet-hap-aapN-avaK|aet
Akinete|Ana|aet-hap-aapN-avaK|_avaK	Akinete|Akr|ahkABNK|ahkK	Akinete|Akr|aet-hap-aapN-avaK|avaK
Akinete|Ana|aet-hap-aapN-avaK|_hap	Akinete|Akr|ahkABNK|ahkB	Akinete|Akr|aet-hap-aapN-avaK|hap
CO2CCM|Carbonicanhydrase|icfA|icfA	CCM|CA|icfA|icfA	CCM|CA|icfA|icfA
CO2CCM|Carboxysome|ccmKLMNO|ccmK	CCM|Carboxysome|ccmKLMNO|ccmK	CCM|Carboxysome|ccmKLMNO|ccmK
CO2CCM|Carboxysome|ccmKLMNO|ccmL	CCM|Carboxysome|ccmKLMNO|ccmL	CCM|Carboxysome|ccmKLMNO|ccmL
CO2CCM|Carboxysome|ccmKLMNO|ccmM	CCM|Carboxysome|ccmKLMNO|ccmM	CCM|Carboxysome|ccmKLMNO|ccmM
CO2CCM|Carboxysome|ccmKLMNO|ccmN	CCM|Carboxysome|ccmKLMNO|ccmN	CCM|Carboxysome|ccmKLMNO|ccmN
CO2CCM|Carboxysome|ccmKLMNO|ccmO	CCM|Carboxysome|ccmKLMNO|ccmO	CCM|Carboxysome|ccmKLMNO|ccmO
CO2CCM|CiT|bicA|bicA	CCM|CiT|bicA|bicA	CCM|CiT|bicA|bicA
CO2CCM|CiT|cmpABCD|cmpA	CCM|CiT|cmpABCD|cmpA	CCM|CiT|cmpABCD|cmpA
CO2CCM|CiT|cmpABCD|cmpB	CCM|CiT|cmpABCD|cmpB	CCM|CiT|cmpABCD|cmpB
CO2CCM|CiT|cmpABCD|cmpC	CCM|CiT|cmpABCD|cmpC	CCM|CiT|cmpABCD|cmpC
CO2CCM|CiT|cmpABCD|cmpD	CCM|CiT|cmpABCD|cmpD	CCM|CiT|cmpABCD|cmpD
CO2CCM|CiT|ndhF3-D3-chpY|chpY	CCM|CiT|cdnDFY|cdnY	CCM|CiT|ndhF3-D3-ndhB-chpY|chpY
CO2CCM|CiT|ndhF3-D3-chpY|ndhD3	CCM|CiT|cdnDFY|cdnD	CCM|CiT|ndhF3-D3-ndhB-chpY|ndhD3
CO2CCM|CiT|ndhF3-D3-chpY|ndhF3	CCM|CiT|cdnDFY|cdnF	CCM|CiT|ndhF3-D3-ndhB-chpY|ndhF3
CO2CCM|CiT|ndhF4D4-chpX|chpX	CCM|CiT|cpnDFX|cpnX	CCM|CiT|ndhF4-D4-nchB-chpX|chpX
CO2CCM|CiT|ndhF4D4-chpX|ndhD4	CCM|CiT|cpnDFX|cpnD	CCM|CiT|ndhF4-D4-nchB-chpX|ndhD4
CO2CCM|CiT|ndhF4D4-chpX|ndhF4	CCM|CiT|cpnDFX|cpnF	CCM|CiT|ndhF4-D4-nchB-chpX|ndhF4
CO2CCM|CiT|sbtA|sbtA	CCM|CiT|sbtA|sbtA	CCM|CiT|sbtA|sbtA
CO2CCM|Rubisco|rbcLS|rbcL	CCM|Rubisco|rbcLS|rbcL	CCM|Rubisco|rbcLS|rbcL
CO2CCM|Rubisco|rbcLS|rbcS	CCM|Rubisco|rbcLS|rbcS	CCM|Rubisco|rbcLS|rbcS
DrugR|DR|acrB/D-A-tolC|_acrA	DrugR|DR|acrBA|tacA	DrugR|DR|acrBA|tacA
DrugR|DR|acrB/D-A-tolC|_acrB	DrugR|DR|acrBA|tacB	DrugR|DR|acrBA|tacAB
DrugR|DR|acrB/D-A-tolC|_acrD	DELETE	DELETE
DrugR|DR|acrB/D-A-tolC|_tolC	DELETE	DELETE
DrugR|DR|emrBA-tolC1|_emrA	DrugR|DR|emrAB|emrA	DrugR|DR|emrAB|emrA
DrugR|DR|emrBA-tolC|_emrB	DrugR|DR|emrAB|emrB	DrugR|DR|emrAB|emrB
DrugR|DR|emrE|_emrE	DrugR|DR|emrE|emrE	DrugR|DR|emrE|emrE
DrugR|DR|lmrP|_lmrP	DrugR|DR|lmrP|lmrP	DrugR|DR|lmrP|lmrP
DrugR|DR|mdfA|_mdfA	DrugR|DR|mdfA|mdfA	DrugR|DR|mdfA|mdfA
DrugR|DR|mexBA-oprM|_mexA	DrugR|DR|omxAB|omxA	DrugR|DR|mexBA-oprM|mexA
DrugR|DR|mexBA-oprM|_mexB	DrugR|DR|omxAB|omxB	DrugR|DR|mexBA-oprM|mexB
DrugR|DR|mexDC-oprJ|_mexC	DrugR|DR|omxCDJ|omxC	DrugR|DR|mexDC-oprJ|mexC
DrugR|DR|mexDC-oprJ|_mexD	DrugR|DR|omxCDJ|omxD	DrugR|DR|mexDC-oprJ|mexD
DrugR|DR|mexDC-oprJ|_oprJ	DrugR|DR|omxCDJ|omxJ	DrugR|DR|mexDC-oprJ|oprJ
DrugR|DR|mexFE-oprN|_mexE	DrugR|DR|omxEFN|omxE	DrugR|DR|mexFE-oprN|mexE
DrugR|DR|mexFE-oprN|_mexF	DrugR|DR|omxEFN|omxF	DrugR|DR|mexFE-oprN|mexF
DrugR|DR|mexFE-oprN|_oprN	DrugR|DR|omxEFN|omxN	DrugR|DR|mexFE-oprN|oprN
DrugR|DR|mexYX-oprM|_mexX	DrugR|DR|omxMYX|omxX	DrugR|DR|mexYX-oprM|mexX
DrugR|DR|mexYX-oprM|_mexY	DrugR|DR|omxMYX|omxY	DrugR|DR|mexYX-oprM|mexY
DrugR|DR|mexYX-oprM|_oprM	DrugR|DR|omxMYX|omxM	DrugR|DR|mexYX-oprM|oprM
DrugR|DR|norA|_norA	DrugR|DR|norA|norA	DrugR|DR|norA|norA
DrugR|DR|qacA/B|_qacA	DrugR|DR|qacA|qacA	DrugR|DR|qacA|qacA
DrugR|DR|qacA/B|_qacB	DrugR|DR|qacA|qacA	DrugR|DR|qacA|qacA
Glycolysis|PDC|aceEF-lpd|aceE	DELETE	DELETE
Glycolysis|PDC|aceEF-lpd|aceF	DELETE	DELETE
Glycolysis|PDC|aceEF-lpd|lpd	DELETE	DELETE
Heavymetal|HM|chrA|_chrA	HMR|HM|chrA|chrA	HMR|HM|chrA|chrA
Heavymetal|HM|cnrABC|_cnrA	HMR|HM|cnrABC|cnrA	HMR|HM|cnrABC|cnrA
Heavymetal|HM|cnrABC|_cnrB	HMR|HM|cnrABC|cnrB	HMR|HM|cnrABC|cnrB
Heavymetal|HM|cnrABC|_cnrC	HMR|HM|cnrABC|cnrC	HMR|HM|cnrABC|cnrC
Heavymetal|HM|cueO|_cueO	HMR|HM|cueO|cueO	HMR|HM|cueO|cueO
Heavymetal|HM|cusABCF|_cusA	HMR|HM|cusABCF|cusA	HMR|HM|cusABCF|cusA
Heavymetal|HM|cusABCF|_cusB	HMR|HM|cusABCF|cusB	HMR|HM|cusABCF|cusB
Heavymetal|HM|cusABCF|_cusC	HMR|HM|cusABCF|cusC	HMR|HM|cusABCF|cusC
Heavymetal|HM|cusABCF|_cusF	HMR|HM|cusABCF|cusF	HMR|HM|cusABCF|cusF
Heavymetal|HM|cutCD|_cutC	HMR|HM|cutC|cutC	HMR|HM|cutC|cutC
Heavymetal|HM|czcABC|_czcA	HMR|HM|czcABC|czcA	HMR|HM|czcABC|czcA
Heavymetal|HM|czcABC|_czcB	HMR|HM|czcABC|czcB	HMR|HM|czcABC|czcB
Heavymetal|HM|czcABC|_czcC	HMR|HM|czcABC|czcC	HMR|HM|czcABC|czcC
Heavymetal|HM|czcD|_czcD	HMR|HM|czcD|czcD	HMR|HM|czcD|czcD
Heavymetal|HM|nccABC|_nccA	HMR|HM|nccABC|nccA	HMR|HM|nccABC|nccA
Heavymetal|HM|nccABC|_nccB	HMR|HM|nccABC|nccB	HMR|HM|nccABC|nccB
Heavymetal|HM|nccABC|_nccC	HMR|HM|nccABC|nccC	HMR|HM|nccABC|nccC
Heavymetal|HM|nreB|_nreB	HMR|HM|nreB|nreB	HMR|HM|nreB|nreB
Heavymetal|HM|zitB|_zitB	HMR|HM|zitB|zitB	HMR|HM|zitB|zitB
Heavymetal|HM|zntA|_zntA	HMR|HM|zntA|zntA	HMR|HM|zntA|zntA
IonDrug|Biotin|bioYMN|_bioM	TEVit|Biotin|bioYMN|bioM	TEVit|Biotin|bioYMN|bioM
IonDrug|Biotin|bioYMN|_bioN	TEVit|Biotin|bioYMN|bioN	TEVit|Biotin|bioYMN|bioN
IonDrug|Biotin|bioYMN|_bioY	TEVit|Biotin|bioYMN|bioY	TEVit|Biotin|bioYMN|bioY
IonDrug|Cobalamin|btuFCD|_btuC	TEVit|Cobalamin|btuCDF|btuC	TEVit|Cobalamin|btuCDF|btuC
IonDrug|Cobalamin|btuFCD|_btuD	TEVit|Cobalamin|btuCDF|btuD	TEVit|Cobalamin|btuCDF|btuD
IonDrug|Cobalamin|btuFCD|_btuF	TEVit|Cobalamin|btuCDF|btuF	TEVit|Cobalamin|btuCDF|btuF
IonDrug|Copper|Atx1|_Atx1	DELETE	DELETE
IonDrug|Copper|copABC|_copA	DELETE	DELETE
IonDrug|Copper|copABC|_copB	DELETE	DELETE
IonDrug|Copper|copABC|_copC	DELETE	DELETE
IonDrug|Copper|copB-alone|_copB	DELETE	DELETE
IonDrug|Copper|ctaA|_ctaA	DELETE	DELETE
IonDrug|Copper|cueO|_cueO	TEVit|Copper|cueO|cueO	TEVit|Copper|cueO|cueO
IonDrug|Copper|pacS|_pacS	TEVit|Copper|pacS|pacS	TEVit|Copper|pacS|pacS
IonDrug|Folate|slr0642|_slr0642	DELETE	DELETE
IonDrug|Iron|fecBED2|_fecB2	DELETE	DELETE
IonDrug|Iron|fecBED2|_fecD2	DELETE	DELETE
IonDrug|Iron|fecBED2|_fecE2	DELETE	DELETE
IonDrug|Iron|fecBEDC1|_fecB1	TEVit|Iron|fecBCDE|fecB	TEVit|Iron|fecBCDE|fecB
IonDrug|Iron|fecBEDC1|_fecC1	TEVit|Iron|fecBCDE|fecC	TEVit|Iron|fecBCDE|fecC
IonDrug|Iron|fecBEDC1|_fecD1	TEVit|Iron|fecBCDE|fecD	TEVit|Iron|fecBCDE|fecD
IonDrug|Iron|fecBEDC1|_fecE1	TEVit|Iron|fecBCDE|fecE	TEVit|Iron|fecBCDE|fecE
IonDrug|Iron|fecEDB3|_fecB3	DELETE	DELETE
IonDrug|Iron|fecEDB3|_fecD3	DELETE	DELETE
IonDrug|Iron|fecEDB3|_fecE3	DELETE	DELETE
IonDrug|Iron|feoAB|_feoA	TEVit|Iron|feoABC|feoA	TEVit|Iron|feoABC|feoA
IonDrug|Iron|feoAB|_feoB	TEVit|Iron|feoABC|feoB	TEVit|Iron|feoABC|feoB
IonDrug|Iron|feoC|_feoC	TEVit|Iron|feoABC|feoC	TEVit|Iron|feoABC|feoC
IonDrug|Iron|fhuBDC|_fhuB	TEVit|Iron|fhuBCD|fhuB	TEVit|Iron|fhuBCD|fhuB
IonDrug|Iron|fhuBDC|_fhuC	TEVit|Iron|fhuBCD|fhuC	TEVit|Iron|fhuBCD|fhuC
IonDrug|Iron|fhuBDC|_fhuD	TEVit|Iron|fhuBCD|fhuD	TEVit|Iron|fhuBCD|fhuD
IonDrug|Iron|futCBA|_futA	TEVit|Iron|futABC|futA	TEVit|Iron|futABC|futA
IonDrug|Iron|futCBA|_futB	TEVit|Iron|futABC|futB	TEVit|Iron|futABC|futB
IonDrug|Iron|futCBA|_futC	TEVit|Iron|futABC|futC	TEVit|Iron|futABC|futC
IonDrug|Iron|sfuA|_sfuA	TEVit|Iron|sfuABC|sfuA	TEVit|Iron|sfuABC|sfuA
IonDrug|Iron|sfuB|_sfuB	TEVit|Iron|sfuABC|sfuB	TEVit|Iron|sfuABC|sfuB
IonDrug|Iron|sfuC|_sfuC	TEVit|Iron|sfuABC|sfuC	TEVit|Iron|sfuABC|sfuC
IonDrug|Iron|sfutABC|_sfutA1	DELETE	DELETE
IonDrug|Iron|sfutABC|_sfutA2	DELETE	DELETE
IonDrug|Iron|sfutABC|_sfutB	DELETE	DELETE
IonDrug|Iron|sfutABC|_sfutC	DELETE	DELETE
IonDrug|Iron|sufBCD|_sufB	TEVit|Iron|sufBCD|sufB	TEVit|Iron|sufBCD|sufB
IonDrug|Iron|sufBCD|_sufC	TEVit|Iron|sufBCD|sufC	TEVit|Iron|sufBCD|sufC
IonDrug|Iron|sufBCD|_sufD	TEVit|Iron|sufBCD|sufD	TEVit|Iron|sufBCD|sufD
IonDrug|Magnesium|corA|_corA	TEVit|Magnesium|corA|corA	TEVit|Magnesium|corA|corA
IonDrug|Magnesium|corC|_corC	TEVit|Magnesium|corC|corC	TEVit|Magnesium|corC|corC
IonDrug|Magnesium|mgtACE|_mgtA	TEVit|Magnesium|mgtACE|mgtA	TEVit|Magnesium|mgtACE|mgtA
IonDrug|Magnesium|mgtACE|_mgtC	TEVit|Magnesium|mgtACE|mgtC	TEVit|Magnesium|mgtACE|mgtC
IonDrug|Magnesium|mgtACE|_mgtE	TEVit|Magnesium|mgtACE|mgtE	TEVit|Magnesium|mgtACE|mgtE
IonDrug|Manganese|manRS|_manR	DELETE	DELETE
IonDrug|Manganese|manRS|_manS	DELETE	DELETE
IonDrug|Manganese|mntABC|_mntA	TEVit|Manganese|mntABC|mntA	TEVit|Manganese|mntABC|mntA
IonDrug|Manganese|mntABC|_mntB	TEVit|Manganese|mntABC|mntB	TEVit|Manganese|mntABC|mntB
IonDrug|Manganese|mntABC|_mntC	TEVit|Manganese|mntABC|mntC	TEVit|Manganese|mntABC|mntC
IonDrug|Nickel|nikABCDE|_nikA	TEVit|Nickel|nikABCDE|nikA	TEVit|Nickel|nikABCDE|nikA
IonDrug|Nickel|nikABCDE|_nikB	TEVit|Nickel|nikABCDE|nikB	TEVit|Nickel|nikABCDE|nikB
IonDrug|Nickel|nikABCDE|_nikC	TEVit|Nickel|nikABCDE|nikC	TEVit|Nickel|nikABCDE|nikC
IonDrug|Nickel|nikABCDE|_nikD	TEVit|Nickel|nikABCDE|nikD	TEVit|Nickel|nikABCDE|nikD
IonDrug|Nickel|nikABCDE|_nikE	TEVit|Nickel|nikABCDE|nikE	TEVit|Nickel|nikABCDE|nikE
IonDrug|Nickel|nikMNOQ|_nikM	TEVit|Nickel|nikMNOQ|nikM	TEVit|Nickel|nikMNOQ|nikM
IonDrug|Nickel|nikMNOQ|_nikN	TEVit|Nickel|nikMNOQ|nikN	TEVit|Nickel|nikMNOQ|nikN
IonDrug|Nickel|nikMNOQ|_nikO	TEVit|Nickel|nikMNOQ|nikO	TEVit|Nickel|nikMNOQ|nikO
IonDrug|Nickel|nikMNOQ|_nikQ	TEVit|Nickel|nikMNOQ|nikQ	TEVit|Nickel|nikMNOQ|nikQ
IonDrug|Riboflavin|YbaA/PnuX/ImpX|_impX	TEVit|Riboflavin|impX|impX	TEVit|Riboflavin|impX|impX
IonDrug|Riboflavin|YbaA/PnuX/ImpX|_pnuX	TEVit|Riboflavin|pnuX|pnuX	TEVit|Riboflavin|pnuX|pnuX
IonDrug|Riboflavin|pnuC|_pnuC	TEVit|Riboflavin|pnuC|pnuC	TEVit|Riboflavin|pnuC|pnuC
MAA|MAA|Ava3855-85|_Ava3855	MAA|MAA|avaABCD|AvaA	MAA|MAA|Ava3855-58|Ava55
MAA|MAA|Ava3855-85|_Ava3856	MAA|MAA|avaABCD|AvaB	MAA|MAA|Ava3855-58|Ava56
MAA|MAA|Ava3855-85|_Ava3857	MAA|MAA|avaABCD|AvaC	MAA|MAA|Ava3855-58|Ava57
MAA|MAA|Ava3855-85|_Ava3858	MAA|MAA|avaABCD|AvaD	MAA|MAA|Ava3855-58|Ava58
Nfix|N|HDCP|_HDCP	DELETE	DELETE
Nfix|N|ccbP|_ccbP	DELETE	DELETE
Nfix|N|devA|_devA	Nfix|N|devABC|devA	Nfix|N|devABC|devA
Nfix|N|devB|_devB	Nfix|N|devABC|devB	Nfix|N|devABC|devB
Nfix|N|devC|_devC	Nfix|N|devABC|devC	Nfix|N|devABC|devC
Nfix|N|fdxH|_fdxH	Nfix|N|fdxH|fdxH	Nfix|N|fdxH|fdxH
Nfix|N|fraG|_fraG	Nfix|N|fraG|fraG	Nfix|N|fraG|fraG
Nfix|N|graG|_graG	DELETE	DELETE
Nfix|N|hepK|_hepK	DELETE	DELETE
Nfix|N|hepN|_hepN	DELETE	DELETE
Nfix|N|hetC|_hetC	Nfix|N|hetC|hetC	Nfix|N|hetC|hetC
Nfix|N|hetF|_hetF	Nfix|N|hetF|hetF	Nfix|N|hetF|hetF
Nfix|N|hetP|_hetP	Nfix|N|hetP|hetP	Nfix|N|hetP|hetP
Nfix|N|hetR|_hetR	Nfix|N|hetR|hetR	Nfix|N|hetR|hetR
Nfix|N|hglB|_hglB	Nfix|N|hglB|hglB	Nfix|N|hglB|hglB
Nfix|N|hglC|_hglC	Nfix|N|hglC|hglC	Nfix|N|hglC|hglC
Nfix|N|hglD|_hglD	Nfix|N|hglD|hglD	Nfix|N|hglD|hglD
Nfix|N|hglE|_hglE	Nfix|N|hglE|hglE	Nfix|N|hglE|hglE
Nfix|N|nifB-fdxN-nifSU|_fdxN	Nfix|N|nifBSNU|nifN	Nfix|N|nifB-fdxN-nifSU|fdxN
Nfix|N|nifB-fdxN-nifSU|_nifB	Nfix|N|nifBSNU|nifB	Nfix|N|nifB-fdxN-nifSU|nifB
Nfix|N|nifB-fdxN-nifSU|_nifS	Nfix|N|nifBSNU|nifS	Nfix|N|nifB-fdxN-nifSU|nifS
Nfix|N|nifB-fdxN-nifSU|_nifU	Nfix|N|nifBSNU|nifU	Nfix|N|nifB-fdxN-nifSU|nifU
Nfix|N|nifE|_nifE	Nfix|N|nifE|nifE	Nfix|N|nifE|nifE
Nfix|N|nifHDK|_nifD	Nfix|N|nifHDK|nifD	Nfix|N|nifHDK|nifD
Nfix|N|nifHDK|_nifH	Nfix|N|nifHDK|nifH	Nfix|N|nifHDK|nifH
Nfix|N|nifHDK|_nifK	Nfix|N|nifHDK|nifK	Nfix|N|nifHDK|nifK
Nfix|N|nifJ|_nifJ	Nfix|N|nifJ|nifJ	Nfix|N|nifJ|nifJ
Nfix|N|nifN|_nifN	Nfix|N|nifN|nifN	Nfix|N|nifN|nifN
Nfix|N|nifO|_nifO	Nfix|N|nifO|nifO	Nfix|N|nifO|nifO
Nfix|N|nifVZT|_nifT	Nfix|N|nifVZT|nifT	Nfix|N|nifVZT|nifT
Nfix|N|nifVZT|_nifV	Nfix|N|nifVZT|nifV	Nfix|N|nifVZT|nifV
Nfix|N|nifVZT|_nifZ	Nfix|N|nifVZT|nifZ	Nfix|N|nifVZT|nifZ
Nfix|N|nifW|_nifW	Nfix|N|nifW|nifW	Nfix|N|nifW|nifW
Nfix|N|nifX|_nifX	Nfix|N|nifX|nifX	Nfix|N|nifX|nifX
Nfix|N|ntcA|_ntcA	Nfix|N|ntcA|ntcA	Nfix|N|ntcA|ntcA
Nfix|N|ompA|_ompA	Nfix|N|ompA|ompA	Nfix|N|ompA|ompA
Nfix|N|ostA|_ostA	Nfix|N|ostA|ostA	Nfix|N|ostA|ostA
Nfix|N|patA|_patA	Nfix|N|patA|patA	Nfix|N|patA|patA
Nfix|N|patB|_patB	Nfix|N|patB|patB	Nfix|N|patB|patB
Nfix|N|patN|_patN	Nfix|N|patN|patN	Nfix|N|patN|patN
Nfix|N|patS|_patS	Nfix|N|patS|patS	Nfix|N|patS|patS
Nitrogen|ammonia|IF1|_IF1	Nitrogen|ammonia|iffA|iffA	Nitrogen|ammonia|iffA|iffA
Nitrogen|ammonia|IF2|_IF2	Nitrogen|ammonia|iffA|iffA	Nitrogen|ammonia|iffA|iffA
Nitrogen|ammonia|PII|_PII	Nitrogen|ammonia|piiA|piiA	Nitrogen|ammonia|piiA|piiA
Nitrogen|ammonia|amt2|_amt2	Nitrogen|ammonia|amtA|amtA	Nitrogen|ammonia|amt|amt
Nitrogen|ammonia|amt3|_amt3	Nitrogen|ammonia|amtA|amtA	Nitrogen|ammonia|amt|amt
Nitrogen|ammonia|cnaT|_cnaT	DELETE	DELETE
Nitrogen|ammonia|gdhA|_gdhA	Nitrogen|ammonia|gdhA|gdhA	Nitrogen|ammonia|gdhA|gdhA
Nitrogen|ammonia|glnA|_glnA	Nitrogen|ammonia|glnA|glnA	Nitrogen|ammonia|glnA|glnA
Nitrogen|ammonia|glnB|_glnB	Nitrogen|ammonia|glnB|glnB	Nitrogen|ammonia|glnB|glnB
Nitrogen|ammonia|glnN|_glnN	Nitrogen|ammonia|glnN|glnN	Nitrogen|ammonia|glnN|glnN
Nitrogen|ammonia|glsF|_glsF	Nitrogen|ammonia|glsF|glsF	Nitrogen|ammonia|glsF|glsF
Nitrogen|ammonia|gltB|_gltB	Nitrogen|ammonia|gltBD|gltB	Nitrogen|ammonia|gltBD|gltB
Nitrogen|ammonia|gltD|_gltD	Nitrogen|ammonia|gltBD|gltD	Nitrogen|ammonia|gltBD|gltD
Nitrogen|ammonia|narM|_narM	Nitrogen|ammonia|narM|narM	Nitrogen|ammonia|narM|narM
Nitrogen|ammonia|nirB|_nirB	Nitrogen|ammonia|nirB|nirB	Nitrogen|ammonia|nirB|nirB
Nitrogen|ammonia|ntcB|_ntcB	Nitrogen|ammonia|ntcB|ntcB	Nitrogen|ammonia|ntcB|ntcB
Nitrogen|ammonia|pipX|_pipX	Nitrogen|ammonia|pipX|pipX	Nitrogen|ammonia|pipX|pipX
Nitrogen|nitrate|narB|_narB	Nitrogen|nitrate|narB|narB	Nitrogen|nitrate|narB|narB
Nitrogen|nitrate|nirA|_nirA	Nitrogen|nitrate|nirA|nirA	Nitrogen|nitrate|nirA|nirA
Nitrogen|nitrate|nrtABCD|_nrtA	Nitrogen|nitrate|nrtABCD|nrtA	Nitrogen|nitrate|nrtABCD|nrtA
Nitrogen|nitrate|nrtABCD|_nrtB	Nitrogen|nitrate|nrtABCD|nrtB	Nitrogen|nitrate|nrtABCD|nrtB
Nitrogen|nitrate|nrtABCD|_nrtC	Nitrogen|nitrate|nrtABCD|nrtC	Nitrogen|nitrate|nrtABCD|nrtC
Nitrogen|nitrate|nrtABCD|_nrtD	Nitrogen|nitrate|nrtABCD|nrtD	Nitrogen|nitrate|nrtABCD|nrtD
Nitrogen|nitrate|nrtP|_nrtP	Nitrogen|nitrate|nrtP|nrtP	Nitrogen|nitrate|nrtP|nrtP
Nitrogen|urea|ureABCDEFG|_ureA	Nitrogen|urea|ureABCDE|ureA	Nitrogen|urea|ureABCDE|ureA
Nitrogen|urea|ureABCDEFG|_ureB	Nitrogen|urea|ureABCDE|ureB	Nitrogen|urea|ureABCDE|ureB
Nitrogen|urea|ureABCDEFG|_ureC	Nitrogen|urea|ureABCDE|ureC	Nitrogen|urea|ureABCDE|ureC
Nitrogen|urea|ureABCDEFG|_ureD	Nitrogen|urea|ureABCDE|ureD	Nitrogen|urea|ureABCDE|ureD
Nitrogen|urea|ureABCDEFG|_ureE	Nitrogen|urea|ureABCDE|ureE	Nitrogen|urea|ureABCDE|ureE
Nitrogen|urea|ureABCDEFG|_ureF	DELETE	DELETE
Nitrogen|urea|ureABCDEFG|_ureG	DELETE	DELETE
Nitrogen|urea|urtABCDE|_urtA	Nitrogen|urea|urtABCDE|urtA	Nitrogen|urea|urtABCDE|urtA
Nitrogen|urea|urtABCDE|_urtB	Nitrogen|urea|urtABCDE|urtB	Nitrogen|urea|urtABCDE|urtB
Nitrogen|urea|urtABCDE|_urtC	Nitrogen|urea|urtABCDE|urtC	Nitrogen|urea|urtABCDE|urtC
Nitrogen|urea|urtABCDE|_urtD	Nitrogen|urea|urtABCDE|urtD	Nitrogen|urea|urtABCDE|urtD
Nitrogen|urea|urtABCDE|_urtE	Nitrogen|urea|urtABCDE|urtE	Nitrogen|urea|urtABCDE|urtE
Osmoprotect|ABC|opuABC|_opuA	DELETE	DELETE
Osmoprotect|ABC|opuABC|_opuB	DELETE	DELETE
Osmoprotect|ABC|opuABC|_opuC	DELETE	DELETE
Osmoprotect|opuABC|opuABC|_opuA	Osmos|betaine|opuABC|opuA	Osmos|betaine|opuABC|opuA
Osmoprotect|opuABC|opuABC|_opuB	Osmos|betaine|opuABC|opuB	Osmos|betaine|opuABC|opuB
Osmoprotect|opuABC|opuABC|_opuC	Osmos|betaine|opuABC|opuC	Osmos|betaine|opuABC|opuC
PS-II|13dDa|psb13|psb13	DELETE	DELETE
PS-II|13dDa|psbW|psbW	DELETE	DELETE
PS-II|CP43|psbC|psbC	PS-II|CP43|psbC|psbC	PS-II|CP43|psbC|psbC
PS-II|CP47|psbB|psbB	PS-II|CP47|psbB|psbB	PS-II|CP47|psbB|psbB
PS-II|Cyt-b559|psbEF|psbE	PS-II|Cyt-b559|psbEF|psbE	PS-II|Cyt-b559|psbEF|psbE
PS-II|Cyt-b559|psbEF|psbF	PS-II|Cyt-b559|psbEF|psbF	PS-II|Cyt-b559|psbEF|psbF
PS-II|Cyt-c550|psbV|psbV	PS-II|Cyt-c550|psbV|psbV	PS-II|Cyt-c550|psbV|psbV
PS-II|D1|psbA|psbA	PS-II|D1|psbA|psbA	PS-II|D1|psbA|psbA
PS-II|D2|psbD|psbD	PS-II|D2|psbD|psbD	PS-II|D2|psbD|psbD
PS-II|II|psbH|psbH	PS-II|II|psbH|psbH	PS-II|II|psbH|psbH
PS-II|II|psbI|psbI	PS-II|II|psbI|psbI	PS-II|II|psbI|psbI
PS-II|II|psbJ|psbJ	PS-II|II|psbJ|psbJ	PS-II|II|psbJ|psbJ
PS-II|II|psbK|psbK	PS-II|II|psbK|psbK	PS-II|II|psbK|psbK
PS-II|II|psbL|psbL	PS-II|II|psbL|psbL	PS-II|II|psbL|psbL
PS-II|II|psbM|psbM	PS-II|II|psbM|psbM	PS-II|II|psbM|psbM
PS-II|II|psbO|psbO	PS-II|II|psbO|psbO	PS-II|II|psbO|psbO
PS-II|II|psbP|psbP	PS-II|II|psbP|psbP	PS-II|II|psbP|psbP
PS-II|II|psbT|psbT	PS-II|II|psbT|psbT	PS-II|II|psbT|psbT
PS-II|II|psbU|psbU	PS-II|II|psbU|psbU	PS-II|II|psbU|psbU
PS-II|II|psbX|psbX	PS-II|II|psbX|psbX	PS-II|II|psbX|psbX
PS-II|II|psbY|psbY	PS-II|II|psbY|psbY	PS-II|II|psbY|psbY
PS-II|II|psbZ|psbZ	PS-II|II|psbZ|psbZ	PS-II|II|psbZ|psbZ
PS-II|Psb27|psbZ|psbZ	DELETE	DELETE
PS-II|Psb27|psbZ|psbZ2	DELETE	DELETE
PS-II|psb28-2II|psb28-2|psb28	DELETE	DELETE
PS-I|ATPase|atpA|atpA	PS-I|ATPase|atpA|atpA	PS-I|ATPase|atpA|atpA
PS-I|ATPase|atpB|atpB	PS-I|ATPase|atpB|atpB	PS-I|ATPase|atpB|atpB
PS-I|ATPase|atpC|atpC	PS-I|ATPase|atpC|atpC	PS-I|ATPase|atpC|atpC
PS-I|ATPase|atpD|atpD	PS-I|ATPase|atpD|atpD	PS-I|ATPase|atpD|atpD
PS-I|ATPase|atpE|atpE	PS-I|ATPase|atpE|atpE	PS-I|ATPase|atpE|atpE
PS-I|ATPase|atpG|atpG	PS-I|ATPase|atpG|atpG	PS-I|ATPase|atpG|atpG
PS-I|ATPase|atpH|atpH	PS-I|ATPase|atpH|atpH	PS-I|ATPase|atpH|atpH
PS-I|ATPase|atpI|atpI	PS-I|ATPase|atpI|atpI	PS-I|ATPase|atpI|atpI
PS-I|Cytb6/f|petA|petA	PS-I|Cytb6/f|petA|petA	PS-I|Cytb6/f|petA|petA
PS-I|Cytb6/f|petB|petB	PS-I|Cytb6/f|petB|petB	PS-I|Cytb6/f|petB|petB
PS-I|Cytb6/f|petC|petC	PS-I|Cytb6/f|petC|petC	PS-I|Cytb6/f|petC|petC
PS-I|Cytb6/f|petD|petD	PS-I|Cytb6/f|petD|petD	PS-I|Cytb6/f|petD|petD
PS-I|Cytb6/f|petG|petG	PS-I|Cytb6/f|petG|petG	PS-I|Cytb6/f|petG|petG
PS-I|Cytb6/f|petL|petL	PS-I|Cytb6/f|petL|petL	PS-I|Cytb6/f|petL|petL
PS-I|Cytb6/f|petM|petM	PS-I|Cytb6/f|petM|petM	PS-I|Cytb6/f|petM|petM
PS-I|Cytb6/f|petN|petN	PS-I|Cytb6/f|petN|petN	PS-I|Cytb6/f|petN|petN
PS-I|Etransport|petE|petE	PS-I|Etransport|petE|petE	PS-I|Etransport|petE|petE
PS-I|Etransport|petF|petF	PS-I|Etransport|petF|petF	PS-I|Etransport|petF|petF
PS-I|Etransport|petH|petH	PS-I|Etransport|petH|petH	PS-I|Etransport|petH|petH
PS-I|Etransport|petJ|petJ	PS-I|Etransport|petJ|petJ	PS-I|Etransport|petJ|petJ
PS-I|PS-Ipsa|psaA|psaA	PS-I|PS-Ipsa|psaA|psaA	PS-I|PS-Ipsa|psaA|psaA
PS-I|PS-Ipsa|psaB|psaB	PS-I|PS-Ipsa|psaB|psaB	PS-I|PS-Ipsa|psaB|psaB
PS-I|PS-Ipsa|psaC|psaC	PS-I|PS-Ipsa|psaC|psaC	PS-I|PS-Ipsa|psaC|psaC
PS-I|PS-Ipsa|psaD|psaD	PS-I|PS-Ipsa|psaD|psaD	PS-I|PS-Ipsa|psaD|psaD
PS-I|PS-Ipsa|psaE|psaE	PS-I|PS-Ipsa|psaE|psaE	PS-I|PS-Ipsa|psaE|psaE
PS-I|PS-Ipsa|psaF|psaF	PS-I|PS-Ipsa|psaF|psaF	PS-I|PS-Ipsa|psaF|psaF
PS-I|PS-Ipsa|psaI|psaI	PS-I|PS-Ipsa|psaI|psaI	PS-I|PS-Ipsa|psaI|psaI
PS-I|PS-Ipsa|psaJ|psaJ	PS-I|PS-Ipsa|psaJ|psaJ	PS-I|PS-Ipsa|psaJ|psaJ
PS-I|PS-Ipsa|psaK|psaK	PS-I|PS-Ipsa|psaK|psaK	PS-I|PS-Ipsa|psaK|psaK
PS-I|PS-Ipsa|psaL|psaL	PS-I|PS-Ipsa|psaL|psaL	PS-I|PS-Ipsa|psaL|psaL
PS-I|PS-Ipsa|psaM|psaM	PS-I|PS-Ipsa|psaM|psaM	PS-I|PS-Ipsa|psaM|psaM
PS-I|PS-Ipsa|psaX|psaX	PS-I|PS-Ipsa|psaX|psaX	PS-I|PS-Ipsa|psaX|psaX
Phosphorus|Pi|AP|_AP	Phosphorus|Pi|appA|appA	Phosphorus|Pi|ap|ap
Phosphorus|Pi|EPP|_EPP	Phosphorus|Pi|eppA|eppA	Phosphorus|Pi|epp|epp
Phosphorus|Pi|IPP|_IPP	Phosphorus|Pi|ippA|ippA	Phosphorus|Pi|ipp|ipp
Phosphorus|Pi|LAT|_LAT	Phosphorus|Pi|latA|latA	Phosphorus|Pi|lat|lat
Phosphorus|Pi|PPK|_PPK	Phosphorus|Pi|ppkA|ppkA	Phosphorus|Pi|ppk|ppk
Phosphorus|Pi|PhoBRU|_PhoB	Phosphorus|Pi|phoBRU|phoB	Phosphorus|Pi|phoBRU|phoB
Phosphorus|Pi|PhoBRU|_PhoR	Phosphorus|Pi|phoBRU|phoR	Phosphorus|Pi|phoBRU|phoR
Phosphorus|Pi|PhoBRU|_PhoU	Phosphorus|Pi|phoBRU|phoU	Phosphorus|Pi|phoBRU|phoU
Phosphorus|Pi|PstSCAB|_PstA	Phosphorus|Pi|pstABCS|pstA	Phosphorus|Pi|pstABCS|pstA
Phosphorus|Pi|PstSCAB|_PstB	Phosphorus|Pi|pstABCS|pstB	Phosphorus|Pi|pstABCS|pstB
Phosphorus|Pi|PstSCAB|_PstC	Phosphorus|Pi|pstABCS|pstC	Phosphorus|Pi|pstABCS|pstC
Phosphorus|Pi|PstSCAB|_PstS	Phosphorus|Pi|pstABCS|pstS	Phosphorus|Pi|pstABCS|pstS
Phosphorus|orgP|PhnCDE|_PhnC	Phosphorus|orgP|phnCDE|phnC	Phosphorus|orgP|phnCDE|phnC
Phosphorus|orgP|PhnCDE|_PhnD	Phosphorus|orgP|phnCDE|phnD	Phosphorus|orgP|phnCDE|phnD
Phosphorus|orgP|PhnCDE|_PhnE	Phosphorus|orgP|phnCDE|phnE	Phosphorus|orgP|phnCDE|phnE
Phosphorus|orgP|PhnF|_PhnF	Phosphorus|orgP|phnF|phnF	Phosphorus|orgP|phnF|phnF
Phosphorus|orgP|PhnGHIJKLMN|_PhnG	Phosphorus|orgP|phnGHIJKLMN|phnG	Phosphorus|orgP|phnGHIJKLMN|phnG
Phosphorus|orgP|PhnGHIJKLMN|_PhnH	Phosphorus|orgP|phnGHIJKLMN|phnH	Phosphorus|orgP|phnGHIJKLMN|phnH
Phosphorus|orgP|PhnGHIJKLMN|_PhnI	Phosphorus|orgP|phnGHIJKLMN|phnI	Phosphorus|orgP|phnGHIJKLMN|phnI
Phosphorus|orgP|PhnGHIJKLMN|_PhnJ	Phosphorus|orgP|phnGHIJKLMN|phnJ	Phosphorus|orgP|phnGHIJKLMN|phnJ
Phosphorus|orgP|PhnGHIJKLMN|_PhnK	Phosphorus|orgP|phnGHIJKLMN|phnK	Phosphorus|orgP|phnGHIJKLMN|phnK
Phosphorus|orgP|PhnGHIJKLMN|_PhnL	Phosphorus|orgP|phnGHIJKLMN|phnL	Phosphorus|orgP|phnGHIJKLMN|phnL
Phosphorus|orgP|PhnGHIJKLMN|_PhnM	Phosphorus|orgP|phnGHIJKLMN|phnM	Phosphorus|orgP|phnGHIJKLMN|phnM
Phosphorus|orgP|PhnGHIJKLMN|_PhnN	Phosphorus|orgP|phnGHIJKLMN|phnN	Phosphorus|orgP|phnGHIJKLMN|phnN
Phosphorus|orgP|PhnO|_PhnO	Phosphorus|orgP|phnO|PhnO	Phosphorus|orgP|phnO|PhnO
Phosphorus|orgP|PhnP|_PhnP	Phosphorus|orgP|phnP|PhnP	Phosphorus|orgP|phnP|PhnP
Phosphorus|orgP|PhnR|_PhnR	Phosphorus|orgP|phnR|PhnR	Phosphorus|orgP|phnR|PhnR
Phosphorus|orgP|PhnSTUV|_PhnS	Phosphorus|orgP|phnSTUV|phnS	Phosphorus|orgP|phnSTUV|phnS
Phosphorus|orgP|PhnSTUV|_PhnT	Phosphorus|orgP|phnSTUV|phnT	Phosphorus|orgP|phnSTUV|phnT
Phosphorus|orgP|PhnSTUV|_PhnU	Phosphorus|orgP|phnSTUV|phnU	Phosphorus|orgP|phnSTUV|phnU
Phosphorus|orgP|PhnSTUV|_PhnV	Phosphorus|orgP|phnSTUV|phnV	Phosphorus|orgP|phnSTUV|phnV
Phosphorus|orgP|PhnWX|_PhnW	Phosphorus|orgP|phnW|phnW	Phosphorus|orgP|phnW|phnW
Phosphorus|orgP|PhnWX|_PhnX	Phosphorus|orgP|phnX|phnX	Phosphorus|orgP|phnX|phnX
Phosphorus|orgP|UgpABCE|_UgpA	Phosphorus|orgP|ugpABCE|ugpA	Phosphorus|orgP|ugpABCE|ugpA
Phosphorus|orgP|UgpABCE|_UgpB	Phosphorus|orgP|ugpABCE|ugpB	Phosphorus|orgP|ugpABCE|ugpB
Phosphorus|orgP|UgpABCE|_UgpC	Phosphorus|orgP|ugpABCE|ugpC	Phosphorus|orgP|ugpABCE|ugpC
Phosphorus|orgP|UgpABCE|_UgpE	Phosphorus|orgP|ugpABCE|ugpE	Phosphorus|orgP|ugpABCE|ugpE
Phosphorus|orgP|UgpQ|_UgpQ	Phosphorus|orgP|ugpQ|ugpQ	Phosphorus|orgP|ugpQ|ugpQ
Photosynthesis|PSB|apcAB|apcA	Photosynthesis|PSB|apcAB|apcA	Photosynthesis|PSB|apcAB|apcA
Photosynthesis|PSB|apcAB|apcB	Photosynthesis|PSB|apcAB|apcB	Photosynthesis|PSB|apcAB|apcB
Photosynthesis|PSB|apcC|apcC	Photosynthesis|PSB|apcC|apcC	Photosynthesis|PSB|apcC|apcC
Photosynthesis|PSB|apcD|apcD	Photosynthesis|PSB|apcD|apcD	Photosynthesis|PSB|apcD|apcD
Photosynthesis|PSB|apcE|apcE	Photosynthesis|PSB|apcE|apcE	Photosynthesis|PSB|apcE|apcE
Photosynthesis|PSB|apcF|apcF	Photosynthesis|PSB|apcF|apcF	Photosynthesis|PSB|apcF|apcF
Photosynthesis|PSB|cpcAB|cpcA	Photosynthesis|PSB|cpcAB|cpcA	Photosynthesis|PSB|cpcAB|cpcA
Photosynthesis|PSB|cpcAB|cpcB	Photosynthesis|PSB|cpcAB|cpcB	Photosynthesis|PSB|cpcAB|cpcB
Photosynthesis|PSB|cpcC|cpcC	Photosynthesis|PSB|cpcC|cpcC	Photosynthesis|PSB|cpcC|cpcC
Photosynthesis|PSB|cpcD|cpcD	Photosynthesis|PSB|cpcD|cpcD	Photosynthesis|PSB|cpcD|cpcD
Photosynthesis|PSB|cpcEF|cpcE	Photosynthesis|PSB|cpcEF|cpcE	Photosynthesis|PSB|cpcEF|cpcE
Photosynthesis|PSB|cpcEF|cpcF	Photosynthesis|PSB|cpcEF|cpcF	Photosynthesis|PSB|cpcEF|cpcF
Photosynthesis|PSB|cpcG|cpcG	Photosynthesis|PSB|cpcG|cpcG	Photosynthesis|PSB|cpcG|cpcG
Photosynthesis|PSB|cpeAB|cpeA	Photosynthesis|PSB|cpeAB|cpeA	Photosynthesis|PSB|cpeAB|cpeA
Photosynthesis|PSB|cpeAB|cpeB	Photosynthesis|PSB|cpeAB|cpeB	Photosynthesis|PSB|cpeAB|cpeB
Photosynthesis|PSB|cpeC|cpeC	Photosynthesis|PSB|cpeC|cpeC	Photosynthesis|PSB|cpeC|cpeC
Photosynthesis|PSB|cpeD|cpeD	Photosynthesis|PSB|cpeD|cpeD	Photosynthesis|PSB|cpeD|cpeD
Photosynthesis|PSB|cpeE|cpeE	Photosynthesis|PSB|cpeE|cpeE	Photosynthesis|PSB|cpeE|cpeE
Photosynthesis|PSB|cpeR|cpeR	Photosynthesis|PSB|cpeR|cpeR	Photosynthesis|PSB|cpeR|cpeR
Photosynthesis|PSB|cpeS|cpeS	Photosynthesis|PSB|cpeS|cpeS	Photosynthesis|PSB|cpeS|cpeS
Photosynthesis|PSB|cpeS|cpeT	Photosynthesis|PSB|cpeS|cpeS	Photosynthesis|PSB|cpeS|cpeS
Photosynthesis|PSB|cpeS|cpeU	Photosynthesis|PSB|cpeS|cpeS	Photosynthesis|PSB|cpeS|cpeS
Photosynthesis|PSB|cpeS|cpeY	Photosynthesis|PSB|cpeS|cpeS	Photosynthesis|PSB|cpeS|cpeS
Photosynthesis|PSB|cpeS|cpeZ	Photosynthesis|PSB|cpeS|cpeS	Photosynthesis|PSB|cpeS|cpeS
Stress|redox|gor|_gor	OSR|redox|gorA|gorA	OSR|redox|gorA|gorA
Stress|redox|gpx|_gpx	OSR|redox|gpxA|gpxA	OSR|redox|gpxA|gpxA
Stress|redox|gshA|_gshA	OSR|redox|gshA|gshA	OSR|redox|gshA|gshA
Stress|redox|gshB|_gshB	OSR|redox|gshB|gshB	OSR|redox|gshB|gshB
Stress|redox|gsiABCD|_gsiA	OSR|redox|gsiABCD|gsiA	OSR|redox|gsiABCD|gsiA
Stress|redox|gsiABCD|_gsiB	OSR|redox|gsiABCD|gsiB	OSR|redox|gsiABCD|gsiB
Stress|redox|gsiABCD|_gsiC	OSR|redox|gsiABCD|gsiC	OSR|redox|gsiABCD|gsiC
Stress|redox|gsiABCD|_gsiD	OSR|redox|gsiABCD|gsiD	OSR|redox|gsiABCD|gsiD
Stress|redox|gstA|_gstA	OSR|redox|gstA|gstA	OSR|redox|gstA|gstA
Stress|redox|katE|_katE	OSR|redox|katE|katE	OSR|redox|katE|katE
Stress|redox|katG|_katG	OSR|redox|katG|katG	OSR|redox|katG|katG
Stress|redox|sodA|_sodA	OSR|redox|sodA|sodA	OSR|redox|sodA|sodA
Stress|redox|sodB|_sodB	OSR|redox|sodB|sodB	OSR|redox|sodB|sodB
Sugar|Chitobiose|ehiEFG|_chiE	Sugar|Chitobiose|ehiEFG|ehiE	Sugar|Chitobiose|ehiEFG|ehiE
Sugar|Chitobiose|ehiEFG|_chiF	Sugar|Chitobiose|ehiEFG|ehiF	Sugar|Chitobiose|ehiEFG|ehiF
Sugar|Chitobiose|ehiEFG|_chiG	Sugar|Chitobiose|ehiEFG|ehiG	Sugar|Chitobiose|ehiEFG|ehiG
Sugar|Glucoside|aglEFGK|_aglE	Sugar|Glucoside|aglEFGK|aglE	Sugar|Glucoside|aglEFGK|aglE
Sugar|Glucoside|aglEFGK|_aglF	Sugar|Glucoside|aglEFGK|aglF	Sugar|Glucoside|aglEFGK|aglF
Sugar|Glucoside|aglEFGK|_aglG	Sugar|Glucoside|aglEFGK|aglG	Sugar|Glucoside|aglEFGK|aglG
Sugar|Glucoside|aglEFGK|_aglK	Sugar|Glucoside|aglEFGK|aglK	Sugar|Glucoside|aglEFGK|aglK
Sugar|Lipopolysaccharide|rfbAB|_rfbA	Sugar|Lipopolysaccharide|rfbAB|rfbA	Sugar|Lipopolysaccharide|rfbAB|rfbA
Sugar|Lipopolysaccharide|rfbAB|_rfbB	Sugar|Lipopolysaccharide|rfbAB|rfbB	Sugar|Lipopolysaccharide|rfbAB|rfbB
Sugar|Malstose|lamB|_lamB	Sugar|Malstose|lamB|lamB	Sugar|Malstose|lamB|lamB
Sugar|Malstose|malKFGE|_malE	Sugar|Malstose|malKFGE|malE	Sugar|Malstose|malKFGE|malE
Sugar|Malstose|malKFGE|_malF	Sugar|Malstose|malKFGE|malF	Sugar|Malstose|malKFGE|malF
Sugar|Malstose|malKFGE|_malG	Sugar|Malstose|malKFGE|malG	Sugar|Malstose|malKFGE|malG
Sugar|Malstose|malKFGE|_malK	Sugar|Malstose|malKFGE|malK	Sugar|Malstose|malKFGE|malK
Sugar|NAG|acs|_acs	Sugar|NAG|acsA|acsA	Sugar|NAG|acs|acs
Sugar|NAG|nagA|_nagA	Sugar|NAG|nagA|nagA	Sugar|NAG|nagA|nagA
Sugar|NAG|nagB|_nagB	Sugar|NAG|nagB|nagB	Sugar|NAG|nagB|nagB
Sugar|NAG|ngcEFG|_ngcE	Sugar|NAG|ngcEFG|ngcE	Sugar|NAG|ngcEFG|ngcE
Sugar|NAG|ngcEFG|_ngcF	Sugar|NAG|ngcEFG|ngcF	Sugar|NAG|ngcEFG|ngcF
Sugar|NAG|ngcEFG|_ngcG	Sugar|NAG|ngcEFG|ngcG	Sugar|NAG|ngcEFG|ngcG
Sugar|NAG|ybfM|_ybfM	Sugar|NAG|ybfM|ybfM	Sugar|NAG|ybfM|ybfM
Sulfur|S1|cysATWP|_cysA	Sulfur|S|cysATWP|cysA	Sulfur|S|cysATWP|cysA
Sulfur|S1|cysATWP|_cysP	Sulfur|S|cysATWP|cysP	Sulfur|S|cysATWP|cysP
Sulfur|S1|cysATWP|_cysT	Sulfur|S|cysATWP|cysT	Sulfur|S|cysATWP|cysT
Sulfur|S1|cysATWP|_cysW	Sulfur|S|cysATWP|cysW	Sulfur|S|cysATWP|cysW
Sulfur|S2|sat|_sat	Sulfur|S|satA|satA	Sulfur|S|satA|satA
Sulfur|S3|cysC|_cysC	Sulfur|S|cysC|cysC	Sulfur|S|cysC|cysC
Sulfur|S4|cysH|_cysH	Sulfur|S|cysH|cysH	Sulfur|S|cysH|cysH
Sulfur|S5|sir|_sir	Sulfur|S|sirA|sirA	Sulfur|S|sirA|sirA
Sulfur|S|cysATWP|_cysA	Sulfur|S|cysATWP|cysA	Sulfur|S|cysATWP|cysA
Sulfur|S|cysATWP|_cysP	Sulfur|S|cysATWP|cysP	Sulfur|S|cysATWP|cysP
Sulfur|S|cysATWP|_cysT	Sulfur|S|cysATWP|cysT	Sulfur|S|cysATWP|cysT
Sulfur|S|cysATWP|_cysW	Sulfur|S|cysATWP|cysW	Sulfur|S|cysATWP|cysW
Sulfur|S|cysC|_cysC	Sulfur|S|cysC|cysC	Sulfur|S|cysC|cysC
Sulfur|S|cysDN|_cysD	Sulfur|S|cysDN|cysD	Sulfur|S|cysDN|cysD
Sulfur|S|cysDN|_cysN	Sulfur|S|cysDN|cysN	Sulfur|S|cysDN|cysN
Sulfur|S|cysE|_cysE	Sulfur|S|cysE|cysE	Sulfur|S|cysE|cysE
Sulfur|S|cysGIJ|_cysG	Sulfur|S|cysGIJ|cysG	Sulfur|S|cysGIJ|cysG
Sulfur|S|cysGIJ|_cysI	Sulfur|S|cysGIJ|cysI	Sulfur|S|cysGIJ|cysI
Sulfur|S|cysGIJ|_cysJ	Sulfur|S|cysGIJ|cysJ	Sulfur|S|cysGIJ|cysJ
Sulfur|S|cysKM|_cysK	Sulfur|S|cysKM|cysK	Sulfur|S|cysKM|cysK
Sulfur|S|cysKM|_cysM	Sulfur|S|cysKM|cysM	Sulfur|S|cysKM|cysM
Sulfur|S|cysZ|_cysZ	Sulfur|S|cysZ|cysZ	Sulfur|S|cysZ|cysZ
Sulfur|S|s111080-2|_sll1080	DELETE	DELETE
Sulfur|S|sc8g1220-22|_sc8g1220	DELETE	DELETE
Sulfur|S|sc8g1220-22|_sc8g1221	DELETE	DELETE
Sulfur|S|sc8g1220-22|_sc8g1222	DELETE	DELETE
Sulfur|S|sll1080-2|_sll1081	DELETE	DELETE
Sulfur|S|sll1080-2|_sll1082	DELETE	DELETE
Sulfur|S|srpKLM|_srpK	Sulfur|S|srpKLM|srpK	Sulfur|S|srpKLM|srpK
Sulfur|S|srpKLM|_srpL	Sulfur|S|srpKLM|srpL	Sulfur|S|srpKLM|srpL
Sulfur|S|srpKLM|_srpM	Sulfur|S|srpKLM|srpM	Sulfur|S|srpKLM|srpM
Sulfur|S|ssuABCDE|_ssuA	Sulfur|S|ssuABCDE|ssuA	Sulfur|S|ssuABCDE|ssuA
Sulfur|S|ssuABCDE|_ssuB	Sulfur|S|ssuABCDE|ssuB	Sulfur|S|ssuABCDE|ssuB
Sulfur|S|ssuABCDE|_ssuC	Sulfur|S|ssuABCDE|ssuC	Sulfur|S|ssuABCDE|ssuC
Sulfur|S|ssuABCDE|_ssuD	Sulfur|S|ssuABCDE|ssuD	Sulfur|S|ssuABCDE|ssuD
Sulfur|S|ssuABCDE|_ssuE	Sulfur|S|ssuABCDE|ssuE	Sulfur|S|ssuABCDE|ssuE
Sulfur|S|sulP|_sulP	Sulfur|S|sulP|sulP	Sulfur|S|sulP|sulP
Sulfur|S|tauABCD|_tauA	Sulfur|S|tauABCD|tauA	Sulfur|S|tauABCD|tauA
Sulfur|S|tauABCD|_tauB	Sulfur|S|tauABCD|tauB	Sulfur|S|tauABCD|tauB
Sulfur|S|tauABCD|_tauC	Sulfur|S|tauABCD|tauC	Sulfur|S|tauABCD|tauC
Sulfur|S|tauABCD|_tauD	Sulfur|S|tauABCD|tauD	Sulfur|S|tauABCD|tauD
TCA|ByPass|OGDC|OGDC	DELETE	DELETE
TCA|ByPass|SSADH|SSADH	DELETE	DELETE
TCA|KGDH|sucAB-lpd|lpd	DELETE	DELETE
TCA|NDH-1|hoxEFU|hoxE	DELETE	DELETE
TCA|NDH-1|hoxEFU|hoxF	DELETE	DELETE
TCA|NDH-1|hoxEFU|hoxU	DELETE	DELETE
TCA|NDH-1|hoxU|hoxF	DELETE	DELETE
TCA|NDH-1|hoxU|hoxU	DELETE	DELETE
TCA|NDH-1|ndhABCDEFGHIJKMLMNXYU|ndh	DELETE	DELETE
TCA|NDH-1|ndhABCDEFGHIJKMLMN|ndhA	DELETE	DELETE
TCA|NDH-1|ndhABCDEFGHIJKMLMN|ndhB	DELETE	DELETE
TCA|NDH-1|ndhABCDEFGHIJKMLMN|ndhC	DELETE	DELETE
TCA|NDH-1|ndhABCDEFGHIJKMLMN|ndhD	DELETE	DELETE
TCA|NDH-1|ndhABCDEFGHIJKMLMN|ndhE	DELETE	DELETE
TCA|NDH-1|ndhABCDEFGHIJKMLMN|ndhF	DELETE	DELETE
TCA|NDH-1|ndhABCDEFGHIJKMLMN|ndhG	DELETE	DELETE
TCA|NDH-1|ndhABCDEFGHIJKMLMN|ndhH	DELETE	DELETE
TCA|NDH-1|ndhABCDEFGHIJKMLMN|ndhI	DELETE	DELETE
TCA|NDH-1|ndhABCDEFGHIJKMLMN|ndhJ	DELETE	DELETE
TCA|NDH-1|ndhABCDEFGHIJKMLMN|ndhK	DELETE	DELETE
TCA|NDH-1|ndhABCDEFGHIJKMLMN|ndhL	DELETE	DELETE
TCA|NDH-1|ndhABCDEFGHIJKMLMN|ndhM	DELETE	DELETE
TCA|NDH-1|ndhABCDEFGHIJKMLMN|ndhN	DELETE	DELETE
TCA|SDH|sdhABCD|sdhC	DELETE	DELETE
TCA|SDH|sdhABCD|sdhD	DELETE	DELETE
TCA|SHD|sdhABCD|sdhC	DELETE	DELETE
TCA|SHD|sdhABCD|sdhD	DELETE	DELETE
Toxins|Anatoxin-a|anaA-H|_anaA	Toxins|Anatoxin-a|anaABCDEFG|anaA	Toxins|Anatoxin-a|anaABCDEFG|anaA
Toxins|Anatoxin-a|anaA-H|_anaB	Toxins|Anatoxin-a|anaABCDEFG|anaB	Toxins|Anatoxin-a|anaABCDEFG|anaB
Toxins|Anatoxin-a|anaA-H|_anaC	Toxins|Anatoxin-a|anaABCDEFG|anaC	Toxins|Anatoxin-a|anaABCDEFG|anaC
Toxins|Anatoxin-a|anaA-H|_anaD	Toxins|Anatoxin-a|anaABCDEFG|anaD	Toxins|Anatoxin-a|anaABCDEFG|anaD
Toxins|Anatoxin-a|anaA-H|_anaE	Toxins|Anatoxin-a|anaABCDEFG|anaE	Toxins|Anatoxin-a|anaABCDEFG|anaE
Toxins|Anatoxin-a|anaA-H|_anaF	Toxins|Anatoxin-a|anaABCDEFG|anaF	Toxins|Anatoxin-a|anaABCDEFG|anaF
Toxins|Anatoxin-a|anaA-H|_anaG	Toxins|Anatoxin-a|anaABCDEFG|anaG	Toxins|Anatoxin-a|anaABCDEFG|anaG
Toxins|Anatoxin-a|anaA-H|_anaH	DELETE	DELETE
Toxins|Cylindrospermopsin|cyrA-O|_cyrA	Toxins|Cylindrospermopsin|cyrABCDEFGHIJKLMNO|cyrA	Toxins|Cylindrospermopsin|cyrABCDEFGHIJKLMNO|cyrA
Toxins|Cylindrospermopsin|cyrA-O|_cyrB	Toxins|Cylindrospermopsin|cyrABCDEFGHIJKLMNO|cyrB	Toxins|Cylindrospermopsin|cyrABCDEFGHIJKLMNO|cyrB
Toxins|Cylindrospermopsin|cyrA-O|_cyrC	Toxins|Cylindrospermopsin|cyrABCDEFGHIJKLMNO|cyrC	Toxins|Cylindrospermopsin|cyrABCDEFGHIJKLMNO|cyrC
Toxins|Cylindrospermopsin|cyrA-O|_cyrD	Toxins|Cylindrospermopsin|cyrABCDEFGHIJKLMNO|cyrD	Toxins|Cylindrospermopsin|cyrABCDEFGHIJKLMNO|cyrD
Toxins|Cylindrospermopsin|cyrA-O|_cyrE	Toxins|Cylindrospermopsin|cyrABCDEFGHIJKLMNO|cyrE	Toxins|Cylindrospermopsin|cyrABCDEFGHIJKLMNO|cyrE
Toxins|Cylindrospermopsin|cyrA-O|_cyrF	Toxins|Cylindrospermopsin|cyrABCDEFGHIJKLMNO|cyrF	Toxins|Cylindrospermopsin|cyrABCDEFGHIJKLMNO|cyrF
Toxins|Cylindrospermopsin|cyrA-O|_cyrG	Toxins|Cylindrospermopsin|cyrABCDEFGHIJKLMNO|cyrG	Toxins|Cylindrospermopsin|cyrABCDEFGHIJKLMNO|cyrG
Toxins|Cylindrospermopsin|cyrA-O|_cyrH	Toxins|Cylindrospermopsin|cyrABCDEFGHIJKLMNO|cyrH	Toxins|Cylindrospermopsin|cyrABCDEFGHIJKLMNO|cyrH
Toxins|Cylindrospermopsin|cyrA-O|_cyrI	Toxins|Cylindrospermopsin|cyrABCDEFGHIJKLMNO|cyrI	Toxins|Cylindrospermopsin|cyrABCDEFGHIJKLMNO|cyrI
Toxins|Cylindrospermopsin|cyrA-O|_cyrJ	Toxins|Cylindrospermopsin|cyrABCDEFGHIJKLMNO|cyrJ	Toxins|Cylindrospermopsin|cyrABCDEFGHIJKLMNO|cyrJ
Toxins|Cylindrospermopsin|cyrA-O|_cyrK	Toxins|Cylindrospermopsin|cyrABCDEFGHIJKLMNO|cyrK	Toxins|Cylindrospermopsin|cyrABCDEFGHIJKLMNO|cyrK
Toxins|Cylindrospermopsin|cyrA-O|_cyrL	Toxins|Cylindrospermopsin|cyrABCDEFGHIJKLMNO|cyrL	Toxins|Cylindrospermopsin|cyrABCDEFGHIJKLMNO|cyrL
Toxins|Cylindrospermopsin|cyrA-O|_cyrN	Toxins|Cylindrospermopsin|cyrABCDEFGHIJKLMNO|cyrM	Toxins|Cylindrospermopsin|cyrABCDEFGHIJKLMNO|cyrM
Toxins|Cylindrospermopsin|cyrA-O|_cyrO	Toxins|Cylindrospermopsin|cyrABCDEFGHIJKLMNO|cyrN	Toxins|Cylindrospermopsin|cyrABCDEFGHIJKLMNO|cyrN
Toxins|Lyngbyatoxin|ltxA-D|_ltxA	Toxins|Lyngbyatoxin|ltxABCD|ltxA	Toxins|Lyngbyatoxin|ltxABCD|ltxA
Toxins|Lyngbyatoxin|ltxA-D|_ltxB	Toxins|Lyngbyatoxin|ltxABCD|ltxB	Toxins|Lyngbyatoxin|ltxABCD|ltxB
Toxins|Lyngbyatoxin|ltxA-D|_ltxC	Toxins|Lyngbyatoxin|ltxABCD|ltxC	Toxins|Lyngbyatoxin|ltxABCD|ltxC
Toxins|Lyngbyatoxin|ltxA-D|_ltxD	Toxins|Lyngbyatoxin|ltxABCD|ltxD	Toxins|Lyngbyatoxin|ltxABCD|ltxD
Toxins|Microcystin|mcyA-J|_mcyA	Toxins|Microcystin|mcyABCDEFGHIJ|mcyA	Toxins|Microcystin|mcyABCDEFGHIJ|mcyA
Toxins|Microcystin|mcyA-J|_mcyB	Toxins|Microcystin|mcyABCDEFGHIJ|mcyB	Toxins|Microcystin|mcyABCDEFGHIJ|mcyB
Toxins|Microcystin|mcyA-J|_mcyC	Toxins|Microcystin|mcyABCDEFGHIJ|mcyC	Toxins|Microcystin|mcyABCDEFGHIJ|mcyC
Toxins|Microcystin|mcyA-J|_mcyD	Toxins|Microcystin|mcyABCDEFGHIJ|mcyD	Toxins|Microcystin|mcyABCDEFGHIJ|mcyD
Toxins|Microcystin|mcyA-J|_mcyE	Toxins|Microcystin|mcyABCDEFGHIJ|mcyE	Toxins|Microcystin|mcyABCDEFGHIJ|mcyE
Toxins|Microcystin|mcyA-J|_mcyF	Toxins|Microcystin|mcyABCDEFGHIJ|mcyF	Toxins|Microcystin|mcyABCDEFGHIJ|mcyF
Toxins|Microcystin|mcyA-J|_mcyG	Toxins|Microcystin|mcyABCDEFGHIJ|mcyG	Toxins|Microcystin|mcyABCDEFGHIJ|mcyG
Toxins|Microcystin|mcyA-J|_mcyH	Toxins|Microcystin|mcyABCDEFGHIJ|mcyH	Toxins|Microcystin|mcyABCDEFGHIJ|mcyH
Toxins|Microcystin|mcyA-J|_mcyI	Toxins|Microcystin|mcyABCDEFGHIJ|mcyI	Toxins|Microcystin|mcyABCDEFGHIJ|mcyI
Toxins|Microcystin|mcyA-J|_mcyJ	Toxins|Microcystin|mcyABCDEFGHIJ|mcyJ	Toxins|Microcystin|mcyABCDEFGHIJ|mcyJ
Toxins|Nodularin|ndaA-I|_ndaA	Toxins|Nodularin|ndaABCDEFGHI|ndaA	Toxins|Nodularin|ndaABCDEFGHI|ndaA
Toxins|Nodularin|ndaA-I|_ndaB	Toxins|Nodularin|ndaABCDEFGHI|ndaB	Toxins|Nodularin|ndaABCDEFGHI|ndaB
Toxins|Nodularin|ndaA-I|_ndaC	Toxins|Nodularin|ndaABCDEFGHI|ndaC	Toxins|Nodularin|ndaABCDEFGHI|ndaC
Toxins|Nodularin|ndaA-I|_ndaD	Toxins|Nodularin|ndaABCDEFGHI|ndaD	Toxins|Nodularin|ndaABCDEFGHI|ndaD
Toxins|Nodularin|ndaA-I|_ndaE	Toxins|Nodularin|ndaABCDEFGHI|ndaE	Toxins|Nodularin|ndaABCDEFGHI|ndaE
Toxins|Nodularin|ndaA-I|_ndaF	Toxins|Nodularin|ndaABCDEFGHI|ndaF	Toxins|Nodularin|ndaABCDEFGHI|ndaF
Toxins|Nodularin|ndaA-I|_ndaG	Toxins|Nodularin|ndaABCDEFGHI|ndaG	Toxins|Nodularin|ndaABCDEFGHI|ndaG
Toxins|Nodularin|ndaA-I|_ndaH	Toxins|Nodularin|ndaABCDEFGHI|ndaH	Toxins|Nodularin|ndaABCDEFGHI|ndaH
Toxins|Nodularin|ndaA-I|_ndaI	Toxins|Nodularin|ndaABCDEFGHI|ndaI	Toxins|Nodularin|ndaABCDEFGHI|ndaI
Toxins|Saxitoxin|sxtA-Z|_sxtA	Toxins|Saxitoxin|sxtABCDEFGHIJKLMNOPQRSTUVWXYZ|sxtA	Toxins|Saxitoxin|sxtABCDEFGHIJKLMNOPQRSTUVWXYZ|sxtA
Toxins|Saxitoxin|sxtA-Z|_sxtB	Toxins|Saxitoxin|sxtABCDEFGHIJKLMNOPQRSTUVWXYZ|sxtB	Toxins|Saxitoxin|sxtABCDEFGHIJKLMNOPQRSTUVWXYZ|sxtB
Toxins|Saxitoxin|sxtA-Z|_sxtC	Toxins|Saxitoxin|sxtABCDEFGHIJKLMNOPQRSTUVWXYZ|sxtC	Toxins|Saxitoxin|sxtABCDEFGHIJKLMNOPQRSTUVWXYZ|sxtC
Toxins|Saxitoxin|sxtA-Z|_sxtD	Toxins|Saxitoxin|sxtABCDEFGHIJKLMNOPQRSTUVWXYZ|sxtD	Toxins|Saxitoxin|sxtABCDEFGHIJKLMNOPQRSTUVWXYZ|sxtD
Toxins|Saxitoxin|sxtA-Z|_sxtE	Toxins|Saxitoxin|sxtABCDEFGHIJKLMNOPQRSTUVWXYZ|sxtE	Toxins|Saxitoxin|sxtABCDEFGHIJKLMNOPQRSTUVWXYZ|sxtE
Toxins|Saxitoxin|sxtA-Z|_sxtF	Toxins|Saxitoxin|sxtABCDEFGHIJKLMNOPQRSTUVWXYZ|sxtF	Toxins|Saxitoxin|sxtABCDEFGHIJKLMNOPQRSTUVWXYZ|sxtF
Toxins|Saxitoxin|sxtA-Z|_sxtG	Toxins|Saxitoxin|sxtABCDEFGHIJKLMNOPQRSTUVWXYZ|sxtG	Toxins|Saxitoxin|sxtABCDEFGHIJKLMNOPQRSTUVWXYZ|sxtG
Toxins|Saxitoxin|sxtA-Z|_sxtH	Toxins|Saxitoxin|sxtABCDEFGHIJKLMNOPQRSTUVWXYZ|sxtH	Toxins|Saxitoxin|sxtABCDEFGHIJKLMNOPQRSTUVWXYZ|sxtH
Toxins|Saxitoxin|sxtA-Z|_sxtI	Toxins|Saxitoxin|sxtABCDEFGHIJKLMNOPQRSTUVWXYZ|sxtI	Toxins|Saxitoxin|sxtABCDEFGHIJKLMNOPQRSTUVWXYZ|sxtI
Toxins|Saxitoxin|sxtA-Z|_sxtJ	Toxins|Saxitoxin|sxtABCDEFGHIJKLMNOPQRSTUVWXYZ|sxtJ	Toxins|Saxitoxin|sxtABCDEFGHIJKLMNOPQRSTUVWXYZ|sxtJ
Toxins|Saxitoxin|sxtA-Z|_sxtK	Toxins|Saxitoxin|sxtABCDEFGHIJKLMNOPQRSTUVWXYZ|sxtK	Toxins|Saxitoxin|sxtABCDEFGHIJKLMNOPQRSTUVWXYZ|sxtK
Toxins|Saxitoxin|sxtA-Z|_sxtL	Toxins|Saxitoxin|sxtABCDEFGHIJKLMNOPQRSTUVWXYZ|sxtL	Toxins|Saxitoxin|sxtABCDEFGHIJKLMNOPQRSTUVWXYZ|sxtL
Toxins|Saxitoxin|sxtA-Z|_sxtM	Toxins|Saxitoxin|sxtABCDEFGHIJKLMNOPQRSTUVWXYZ|sxtM	Toxins|Saxitoxin|sxtABCDEFGHIJKLMNOPQRSTUVWXYZ|sxtM
Toxins|Saxitoxin|sxtA-Z|_sxtN	Toxins|Saxitoxin|sxtABCDEFGHIJKLMNOPQRSTUVWXYZ|sxtN	Toxins|Saxitoxin|sxtABCDEFGHIJKLMNOPQRSTUVWXYZ|sxtN
Toxins|Saxitoxin|sxtA-Z|_sxtO	Toxins|Saxitoxin|sxtABCDEFGHIJKLMNOPQRSTUVWXYZ|sxtO	Toxins|Saxitoxin|sxtABCDEFGHIJKLMNOPQRSTUVWXYZ|sxtO
Toxins|Saxitoxin|sxtA-Z|_sxtP	Toxins|Saxitoxin|sxtABCDEFGHIJKLMNOPQRSTUVWXYZ|sxtP	Toxins|Saxitoxin|sxtABCDEFGHIJKLMNOPQRSTUVWXYZ|sxtP
Toxins|Saxitoxin|sxtA-Z|_sxtQ	Toxins|Saxitoxin|sxtABCDEFGHIJKLMNOPQRSTUVWXYZ|sxtQ	Toxins|Saxitoxin|sxtABCDEFGHIJKLMNOPQRSTUVWXYZ|sxtQ
Toxins|Saxitoxin|sxtA-Z|_sxtR	Toxins|Saxitoxin|sxtABCDEFGHIJKLMNOPQRSTUVWXYZ|sxtR	Toxins|Saxitoxin|sxtABCDEFGHIJKLMNOPQRSTUVWXYZ|sxtR
Toxins|Saxitoxin|sxtA-Z|_sxtS	Toxins|Saxitoxin|sxtABCDEFGHIJKLMNOPQRSTUVWXYZ|sxtS	Toxins|Saxitoxin|sxtABCDEFGHIJKLMNOPQRSTUVWXYZ|sxtS
Toxins|Saxitoxin|sxtA-Z|_sxtT	Toxins|Saxitoxin|sxtABCDEFGHIJKLMNOPQRSTUVWXYZ|sxtT	Toxins|Saxitoxin|sxtABCDEFGHIJKLMNOPQRSTUVWXYZ|sxtT
Toxins|Saxitoxin|sxtA-Z|_sxtU	Toxins|Saxitoxin|sxtABCDEFGHIJKLMNOPQRSTUVWXYZ|sxtU	Toxins|Saxitoxin|sxtABCDEFGHIJKLMNOPQRSTUVWXYZ|sxtU
Toxins|Saxitoxin|sxtA-Z|_sxtV	Toxins|Saxitoxin|sxtABCDEFGHIJKLMNOPQRSTUVWXYZ|sxtV	Toxins|Saxitoxin|sxtABCDEFGHIJKLMNOPQRSTUVWXYZ|sxtV
Toxins|Saxitoxin|sxtA-Z|_sxtW	Toxins|Saxitoxin|sxtABCDEFGHIJKLMNOPQRSTUVWXYZ|sxtW	Toxins|Saxitoxin|sxtABCDEFGHIJKLMNOPQRSTUVWXYZ|sxtW
Toxins|Saxitoxin|sxtA-Z|_sxtX	Toxins|Saxitoxin|sxtABCDEFGHIJKLMNOPQRSTUVWXYZ|sxtX	Toxins|Saxitoxin|sxtABCDEFGHIJKLMNOPQRSTUVWXYZ|sxtX
Toxins|Saxitoxin|sxtA-Z|_sxtY	Toxins|Saxitoxin|sxtABCDEFGHIJKLMNOPQRSTUVWXYZ|sxtY	Toxins|Saxitoxin|sxtABCDEFGHIJKLMNOPQRSTUVWXYZ|sxtY
Toxins|Saxitoxin|sxtA-Z|_sxtZ	Toxins|Saxitoxin|sxtABCDEFGHIJKLMNOPQRSTUVWXYZ|sxtZ	Toxins|Saxitoxin|sxtABCDEFGHIJKLMNOPQRSTUVWXYZ|sxtZ
UnsatFA|MUFA|dDesaturase|_desA	UnsatFA|MUFA|desABCDEF|desA	UnsatFA|MUFA|desABCDEF|desA
UnsatFA|MUFA|dDesaturase|_desB	UnsatFA|MUFA|desABCDEF|desB	UnsatFA|MUFA|desABCDEF|desB
UnsatFA|MUFA|dDesaturase|_desC	UnsatFA|MUFA|desABCDEF|desC	UnsatFA|MUFA|desABCDEF|desC
UnsatFA|MUFA|dDesaturase|_desC1	UnsatFA|MUFA|desABCDEF|desC	UnsatFA|MUFA|desABCDEF|desC
UnsatFA|MUFA|dDesaturase|_desC2	UnsatFA|MUFA|desABCDEF|desC	UnsatFA|MUFA|desABCDEF|desC
UnsatFA|MUFA|dDesaturase|_desD	UnsatFA|MUFA|desABCDEF|desD	UnsatFA|MUFA|desABCDEF|desD
UnsatFA|MUFA|dDesaturase|_desE	UnsatFA|MUFA|desABCDEF|desE	UnsatFA|MUFA|desABCDEF|desE
UnsatFA|MUFA|dDesaturase|_desF	UnsatFA|MUFA|desABCDEF|desF	UnsatFA|MUFA|desABCDEF|desF
UnsatFA|PUFA|pfaABCDE|_pfaA	UnsatFA|PUFA|pfaABCDE|pfaA	UnsatFA|PUFA|pfaABCDE|pfaA
UnsatFA|PUFA|pfaABCDE|_pfaB	UnsatFA|PUFA|pfaABCDE|pfaB	UnsatFA|PUFA|pfaABCDE|pfaB
UnsatFA|PUFA|pfaABCDE|_pfaB/C	UnsatFA|PUFA|pfaABCDE|pfaB	UnsatFA|PUFA|pfaABCDE|pfaBC
UnsatFA|PUFA|pfaABCDE|_pfaC	UnsatFA|PUFA|pfaABCDE|pfaC	UnsatFA|PUFA|pfaABCDE|pfaC
UnsatFA|PUFA|pfaABCDE|_pfaD	UnsatFA|PUFA|pfaABCDE|pfaD	UnsatFA|PUFA|pfaABCDE|pfaD
UnsatFA|PUFA|pfaABCDE|_pfaE	UnsatFA|PUFA|pfaABCDE|pfaE	UnsatFA|PUFA|pfaABCDE|pfaE
UnsatFA|PUFA|pfaR|_pfaR	UnsatFA|PUFA|pfaR|pfaR	UnsatFA|PUFA|pfaR|pfaR
Vesible|gvesicle|gvpA1|_gvpA1	Vesicle|gvesicle|gvpA|gvpA	Vesicle|gvesicle|gvpA|gvpA
Vesible|gvesicle|gvpA2|_gvpA2	Vesicle|gvesicle|gvpA|gvpA	Vesicle|gvesicle|gvpA|gvpA
Vesible|gvesicle|gvpA3|_gvpA3	Vesicle|gvesicle|gvpA|gvpA	Vesicle|gvesicle|gvpA|gvpA
Vesible|gvesicle|gvpA4|_gvpA4	Vesicle|gvesicle|gvpA|gvpA	Vesicle|gvesicle|gvpA|gvpA
Vesible|gvesicle|gvpA5|_gvpA5	Vesicle|gvesicle|gvpA|gvpA	Vesicle|gvesicle|gvpA|gvpA
Vesible|gvesicle|gvpA6|_gvpA6	Vesicle|gvesicle|gvpA|gvpA	Vesicle|gvesicle|gvpA|gvpA
Vesible|gvesicle|gvpA7|_gvpA7	Vesicle|gvesicle|gvpA|gvpA	Vesicle|gvesicle|gvpA|gvpA
Vesible|gvesicle|gvpAIII|_gvpAIII	Vesicle|gvesicle|gvpA|gvpA	Vesicle|gvesicle|gvpA|gvpA
Vesible|gvesicle|gvpAII|_gvpAII	Vesicle|gvesicle|gvpA|gvpA	Vesicle|gvesicle|gvpA|gvpA
Vesible|gvesicle|gvpAI|_gvpAI	Vesicle|gvesicle|gvpA|gvpA	Vesicle|gvesicle|gvpA|gvpA
Vesible|gvesicle|gvpA|_gvpA	Vesicle|gvesicle|gvpA|gvpA	Vesicle|gvesicle|gvpA|gvpA
Vesible|gvesicle|gvpC|_gvpC	Vesicle|gvesicle|gvpC|gvpC	Vesicle|gvesicle|gvpC|gvpC
Vesible|gvesicle|gvpF|_gvpF	Vesicle|gvesicle|gvpF|gvpF	Vesicle|gvesicle|gvpF|gvpF
Vesible|gvesicle|gvpG|_gvpG	Vesicle|gvesicle|gvpG|gvpG	Vesicle|gvesicle|gvpG|gvpG
Vesible|gvesicle|gvpJ|_gvpJ	Vesicle|gvesicle|gvpJ|gvpJ	Vesicle|gvesicle|gvpJ|gvpJ
Vesible|gvesicle|gvpK|_gvpK	Vesicle|gvesicle|gvpK|gvpK	Vesicle|gvesicle|gvpK|gvpK
Vesible|gvesicle|gvpN|_gvpN	Vesicle|gvesicle|gvpN|gvpN	Vesicle|gvesicle|gvpN|gvpN
Vesible|gvesicle|gvpV|_gvpV	Vesicle|gvesicle|gvpV|gvpV	Vesicle|gvesicle|gvpV|gvpV
Vesible|gvesicle|gvpW|_gvpW	Vesicle|gvesicle|gvpW|gvpW	Vesicle|gvesicle|gvpW|gvpW
Vesicle|Gas|Gene|_gvpA1	Vesicle|gvesicle|gvpA|gvpA	Vesicle|gvesicle|gvpA|gvpA
Vesicle|Gas|Gene|_gvpA2	Vesicle|gvesicle|gvpA|gvpA	Vesicle|gvesicle|gvpA|gvpA
Vesicle|Gas|Gene|_gvpA3	Vesicle|gvesicle|gvpA|gvpA	Vesicle|gvesicle|gvpA|gvpA
Vesicle|Gas|Gene|_gvpA4	Vesicle|gvesicle|gvpA|gvpA	Vesicle|gvesicle|gvpA|gvpA
Vesicle|Gas|Gene|_gvpA5	Vesicle|gvesicle|gvpA|gvpA	Vesicle|gvesicle|gvpA|gvpA
Vesicle|Gas|Gene|_gvpA6	Vesicle|gvesicle|gvpA|gvpA	Vesicle|gvesicle|gvpA|gvpA
Vesicle|Gas|Gene|_gvpA7	Vesicle|gvesicle|gvpA|gvpA	Vesicle|gvesicle|gvpA|gvpA
Vesicle|Gas|Gene|_gvpC	Vesicle|gvesicle|gvpC|gvpC	Vesicle|gvesicle|gvpC|gvpC
Vesicle|Gas|Gene|_gvpF	Vesicle|gvesicle|gvpF|gvpF	Vesicle|gvesicle|gvpF|gvpF
Vesicle|Gas|Gene|_gvpJ	Vesicle|gvesicle|gvpJ|gvpJ	Vesicle|gvesicle|gvpJ|gvpJ
Vesicle|Gas|Gene|_gvpK	Vesicle|gvesicle|gvpK|gvpK	Vesicle|gvesicle|gvpK|gvpK
Vesicle|Gas|Gene|_gvpN	Vesicle|gvesicle|gvpN|gvpN	Vesicle|gvesicle|gvpN|gvpN
Vesicle|Gas|Gene|_gvpV	Vesicle|gvesicle|gvpV|gvpV	Vesicle|gvesicle|gvpV|gvpV
Vesicle|Gas|Gene|_gvpW	Vesicle|gvesicle|gvpW|gvpW	Vesicle|gvesicle|gvpW|gvpW
Vesicle|Gene|gvp|_gvpA	Vesicle|gvesicle|gvpA|gvpA	Vesicle|gvesicle|gvpA|gvpA
Vesicle|Gene|gvp|_gvpC	Vesicle|gvesicle|gvpC|gvpC	Vesicle|gvesicle|gvpC|gvpC
Vesicle|Gene|gvp|_gvpC20	Vesicle|gvesicle|gvpC|gvpC	Vesicle|gvesicle|gvpC|gvpC
Vesicle|Gene|gvp|_gvpD	Vesicle|gvesicle|gvpD|gvpD	Vesicle|gvesicle|gvpD|gvpD
Vesicle|Gene|gvp|_gvpE	Vesicle|gvesicle|gvpE|gvpE	Vesicle|gvesicle|gvpE|gvpE
Vesicle|Gene|gvp|_gvpF	Vesicle|gvesicle|gvpF|gvpF	Vesicle|gvesicle|gvpF|gvpF
Vesicle|Gene|gvp|_gvpG	Vesicle|gvesicle|gvpG|gvpG	Vesicle|gvesicle|gvpG|gvpG
Vesicle|Gene|gvp|_gvpH	Vesicle|gvesicle|gvpH|gvpH	Vesicle|gvesicle|gvpH|gvpH
Vesicle|Gene|gvp|_gvpI	Vesicle|gvesicle|gvpI|gvpI	Vesicle|gvesicle|gvpI|gvpI
Vesicle|Gene|gvp|_gvpJ	Vesicle|gvesicle|gvpJ|gvpJ	Vesicle|gvesicle|gvpJ|gvpJ
Vesicle|Gene|gvp|_gvpK	Vesicle|gvesicle|gvpK|gvpK	Vesicle|gvesicle|gvpK|gvpK
Vesicle|Gene|gvp|_gvpL	Vesicle|gvesicle|gvpL|gvpL	Vesicle|gvesicle|gvpL|gvpL
Vesicle|Gene|gvp|_gvpM	Vesicle|gvesicle|gvpM|gvpM	Vesicle|gvesicle|gvpM|gvpM
Vesicle|Gene|gvp|_gvpN	Vesicle|gvesicle|gvpN|gvpN	Vesicle|gvesicle|gvpN|gvpN
Vesicle|Gene|gvp|_gvpO	Vesicle|gvesicle|gvpO|gvpO	Vesicle|gvesicle|gvpO|gvpO
Vesicle|Gene|gvp|_gvpV	Vesicle|gvesicle|gvpV|gvpV	Vesicle|gvesicle|gvpV|gvpV
Vesicle|Gene|gvp|_gvpW	Vesicle|gvesicle|gvpW|gvpW	Vesicle|gvesicle|gvpW|gvpW
Vesicle|Gene|gvp|_gvpX	Vesicle|gvesicle|gvpX|gvpX	Vesicle|gvesicle|gvpX|gvpX
